                     ###
######################s############
#     e             #    #        #
#                   #    #        #
#   #########   #   #    #        #
#           #   #   #    #        #
#           #   #        #        #
#     #######   ##########        #
#     #                         p #
#     #                           #
#     #   ###############         #
#     #                 #         #
#  e  #                 #         #
#     #                 #         #
#     #                 #         #
#     #                 #         #
#  *  #                *#         #
###################################
