#######################################
#                                     # 
#                                     #
#      #     ##################       #
#      #     #*             e #       #
#  e   #     #                #       #
#      #     #    e           #       #
#      #     ############     #       #
#      #                      #   e   #
#      #  e                   #       #
#      ########################       #
#      #*               #*            #
#      #e               #             #
#      #           #    #e            #
#                  #    #             #
#                  # p  #             #
###########################s###########
