###################################
#                   #    #  .  #  #
#                   #    #        #
#   #########   #   #    #        #
#           #   #   #    #        #
#           #   #        #        #
#     #######   ##########        #
#     #                           #
#     #                           #
#     #   ###############         #
#     #                 #         #
#     #                 #         #
#     #                 #         #
#     #                 #         #
#     #                 #         #
#     #                 #         #
###################################
