#########################
#  .                    #
#                       #
#     #                 #
#     #######           #
#     #                 #
#     #                 #
#     #                 #
#     #                 #
#     #                 #
#     #                 #
#     #                 #
#     #                 #
#########################
