#########################
#  .  #      #          #
#     #      #          #
#     #                 #
#     #######           #
#                       #
#                       #
#                       #
#                       #
#                       #
#                       #
#                       #
#                       #
#########################
