#########################
#  .                    #
#                       #
#     #                 #
#     #######           #
#     #             #   #
#     #    #            #
#     #          #      #
#     #    #            #
#     #                 #
#     #            #    #
#     #      #          #
#     #                 #
#########################
